numMazes: 5
mazeSize: 10
Maze 1
101 82 3.1071428571 2.0891132189 50 0.373899364325140
50 99 80 50 50 74 71 58 83 10 95 47 53 35 100 50
49 79 400 400 44 400 51 53 3 5 45 43 33 95 400
402 402 400 400 402 400 402 402 402 402 402 402 402 401 400
0 0 1 1 1 1 1 1 1 1
0 0 1 0 1 0 0 0 0 0
0 0 1 0 1 0 0 0 0 0
0 0 1 1 1 0 0 0 0 0
0 0 1 1 1 1 1 1 1 2
1 1 1 1 1 1 1 1 1 1
1 0 1 1 1 0 0 0 1 1
1 1 1 1 1 0 0 0 1 1
0 0 1 0 1 0 0 0 1 1
0 0 0 0 1 1 1 1 1 1
Maze 2
87 133 3.4347826087 2.0892875990 33 0.393086225519880
4 75 61 24 42 38 44 44 1 18 56 10 44 55 57 4
74 71 21 22 32 34 400 41 11 16 6 4 54 400 54
401 401 402 402 402 402 400 401 401 402 402 402 401 400 401
1 0 0 2 1 1 1 1 1 1
1 1 1 1 1 1 1 1 0 0
1 1 1 1 0 1 0 0 0 0
1 1 1 1 1 1 1 1 0 0
1 1 1 1 0 1 0 0 0 0
1 0 0 1 1 1 1 0 0 0
1 0 0 1 0 0 0 0 0 0
1 1 1 1 1 0 0 0 0 0
0 0 0 0 0 0 0 0 0 0
0 0 0 0 0 0 0 0 0 0
Maze 3
99 51 2.9259259259 1.9523029392 84 0.394498605083758
51 36 70 37 42 97 94 15 89 34 17 37 85 46 85 51
31 66 67 32 92 400 14 85 84 14 400 35 45 45 81
402 401 401 402 401 400 402 401 401 402 400 402 402 402 401
0 0 0 0 0 0 0 0 0 0
0 0 0 1 1 1 1 0 0 0
0 0 0 1 1 0 1 0 0 0
1 1 1 1 1 1 1 0 0 0
1 1 0 1 1 1 1 0 0 0
2 1 0 1 1 1 1 0 0 0
1 1 0 1 1 1 1 1 1 1
1 1 0 1 1 0 0 0 0 0
1 1 1 1 1 1 1 1 1 0
0 1 1 1 1 1 1 0 0 0
Maze 4
87 37 3.2156862745 2.2057836679 44 0.377619173641306
55 93 66 46 39 47 80 99 11 97 32 59 70 68 55 55
53 63 400 36 37 77 79 91 91 92 52 69 400 65 400
402 402 400 402 402 401 402 401 401 401 401 401 400 401 400
0 0 0 0 0 0 0 0 0 0
1 0 0 0 0 0 0 0 0 0
1 0 0 0 0 0 0 0 0 0
1 1 0 0 0 1 1 1 1 0
1 1 0 0 0 1 1 0 0 0
1 1 1 1 2 1 1 1 1 0
1 1 1 1 1 1 1 1 1 1
1 1 1 0 0 0 1 1 1 1
1 1 1 0 0 0 0 0 1 0
1 1 1 1 1 1 1 1 1 0
Maze 5
87 43 3.7272727273 2.0720409095 50 0.401300474628230
49 57 47 29 46 16 64 68 32 77 7 79 53 59 64 49
47 400 27 26 400 14 400 62 72 400 77 73 400 54 44
402 400 402 402 400 402 400 401 401 400 401 401 400 402 402
0 0 0 0 0 0 1 0 0 0
0 0 0 1 1 1 1 0 0 0
0 0 0 1 0 1 1 1 1 0
0 1 0 1 0 1 1 0 0 0
0 1 0 1 1 1 1 1 2 0
0 1 1 1 1 1 1 1 1 0
0 1 1 1 1 1 1 1 0 0
0 1 1 1 1 1 1 1 1 0
0 0 0 0 0 0 0 0 0 0
0 0 0 0 0 0 0 0 0 0
